F
10
10
WWWWWWWWWW
W@    R  W
W R G    W
W G C VE W
W E A G  W
W G V    W
W A G C GW
W A  C C W
W B B B  W
WWWWWWWWWW
